album count: 117

1/10 - 2/10: olive
3/10 - 4/10: yellow
5/10 - 6/10: orange
7/10 - 8/10: red
9/10 - 10/10: maroon

-------------------------------------------------------------
10/10: 6
black midi - cavalcade
godspeed you! black emperor - g_d's pee at states end!
pinegrove - amperland,ny
porter robinson - nurture
rochelle jordan - play with the changes
sweet trip - a tiny house, in secret speeches, polar equals
-------------------------------------------------------------
9 / 10: 9
black dresses - forever in your heart
frogman - slyme koro
iglooghost - lei line eon
natalia lafourcade - un canto por mexico vol 2
radio supernova - takaisin
renee reed - self titled
slowthai - tyron
spirit of the beehive - entertainment, death
squid - bright green field
-------------------------------------------------------------
8 / 10: 31
aly & aj - a touch of the beat gets you up on your feet gets you out and then into the sun
babii - miirror
black country, new road - for the first time
brockhampton - roadrunner
bruno pernadas - private reasons
chad vangaalen - worlds most stressed out gardener
chai - wink
crumb - ice melt
david john morris - monastic love songs
dawn richard - second line
dry cleaning - new long leg
duda beat - te amo la fora
erika de casier - sensational
genesis owusu - smiling with no teeth
iceage - seek shelter
kučka - wrestling
lana del rey - chemtrails over the country club
mat sweeney / bonnie "prince" billy - superwolves
max bloom - pedestrian
parannoul - to see the next part of the dream
patricia taxxon - daylight spectrum
patricia taxxon - yes, and
shame - drunk tank pink
shelley - shelley fka dram
skyzoo - all the brilliant things
st vincent - daddy's home
teke::teke - shirushi
the weather station - ignorance
wolf alice - blue weekend
xiu xiu - oh no
yu su - yellow river blue
-------------------------------------------------------------
7 / 10: 38
amythyst kiah - wary + strange
armand hammer + the alchemist - haram
cadence weapon - parallel world
cfcf - memoryland
claud - super monster
dayglow - harmony house
denzel curry x kenny beats - unlocked 1.5
dodie - build a problem
doss - 4 new hit songs
ethel cain - inbred EP
georgia anne muldrow - vweto iii
girl in red - if i could make it go quiet
goldlink - haram!
jack ingram / miranda lambert / jon randall - the marfa tapes
japanese breakfast - jubilee
jazmine sullivan - heaux tales EP
jorja smith - be right back EP
king gizzard and the lizard wizard - butterfly 3000
left at london, - t.i.a.p.f.y.h.
loraine james - reflection
mdou moctar - afrique victime
medhane - amythest of morning
mon laferte - seis
olivia rodrigo - sour
origami angel - gami gang
patrick paige - if i fail are we still cool?
patricia taxxon - new piranesi
pi'erre bourne - the life of pi'erre 5
polo g - hall of fame
pom poko - cheater
raheem devaughn / apollo brown - lovesick
rebecca black - rebecca black was here
remember sports - like a stone
run river north - creatures in your head
sleater kinney - path of wellness
sons of kemet - black to the future
underscores - fishmonger
taylor swift - fearless (taylor's version)
-------------------------------------------------------------
6 / 10: 15
arlo parks - collapsed in sunbeams
cacola - a gift to us all
chance de la soul - afterparty
cola boyy - prosthetic boombox
czarface / mf doom - super what?
danny l. harle - harlecore
dinosaur jr - sweep it into space
fatima al qadiri - medieval femme
julien baker - little oblivions
kings of convenience - peace or love
mach-hommy - pray for haiti
man on man - self-titled
mykki blanco - broken hearts and beauty sleep
rap ferreira - bob's son
teenage fanclub - endless arcade
-------------------------------------------------------------
5 / 10: 7
ashnikko - demidevil
arooj aftab - vulture prince
backxwash - i lie here buried with my rings and my dresses
manchester orchestra - the million masks of god
selena gomez - revelación EP
slayyyter - troubled paradise
weezer - van weezer
-------------------------------------------------------------
4 / 10: 5
dmx - exodus
h.e.r. - back of my mind
j cole - the off season
madison beer - life support
rostam - changephobia
-------------------------------------------------------------
3 / 10: 2
weezer - ok human
twenty one pilots - scaled and icy
-------------------------------------------------------------
2 / 10: 2
justin bieber - justice
migos - culture iii
-------------------------------------------------------------
1 / 10: 2
AJR - ok orchestra
maroon 5 - jordi
